**********
*2   * 9 *
** **** **
**    3 **
*  ***  **
* 5 ** * *
* * **   *
*  7 *** *
*    **1 *
*  *     *
******** *
